%%%%%%%%%%%%%%%%%%%%%%%%%%
%B                       %
%$$   $$            $    %
%           $$$$$$$$$$$  %
%                     $  %
%                  E  $  %
%               $$       %
%$$ $$$$$$$$$$$$$        %
%                        %
% $$ E          $$$$$$$  %
%    $$$$$$$$$$$$$  E    %
%%%%%%%%%%%%%%%%%%%%%%%%%%
