%%%%%%%%%%%%%
%           %
%B         R%
%           %
%%%%%%%%%%%%%
