%%%%%%%%%%%%%%%%%%%%%%
%  B                 %
%                    %
%                  B %
%          %         %
%B                   %
%                    %
%        %           %
%                    %
%                   R%
%%%%%%%%%%%%%%%%%%%%%%
