%%%%%%%%%%%%%%%%%%%%%%%%%%%%%%%%%%%%%%%%%%%%
%B     %                                   %
%             %                  %         %
%     %              %   %                 %
%         %  %                             %
%    %           %       %      %          %
%        %    %       %           %        %
%   %              %      %                %
%          %     %                  %      %
%         %   %      %         %           %
%          %       %    %                  %
%        %                 %    % %        %
%          %          %                    %
%   %          %               %           %
%            %                             % 
%   %    %      %  %    %     %            %
%                                      T   %
%                                          %
%%%%%%%%%%%%%%%%%%%%%%%%%%%%%%%%%%%%%%%%%%%%
