%%%%%%%%%%%%%%%%%%%%%%
% B                  %
%    B               %
%                    %
%          %         %
%                    %
%                    %
%        %          B%
%                  $$%
%                B$$V%
%%%%%%%%%%%%%%%%%%%%%%
