%%%%%%%%%%%%%%%%%%%%%%
% B  $           %   %
%                    %
%            B$$  %  %
%  %       % $       %
%                    %
%    $        E      %
%        %           %
%             $      %
%%                  B%
%%%%%%%%%%%%%%%%%%%%%%
